name: The Final Lantern
description: The deepest darkness. Two locks, three keys. Find the spare. Climb to survive.
crystalsNeeded: 6
grid:
 1  1  1  1  1  1  1  1  1  1  1  1  1  1  1  1  1  1
 1  4  0  0  1  0  0  0  0  1  0  2  0  0  0  0  0  1
 1  1  1  0  1  0  1  1  0  1  0  1  1  1  0  1  0  1
 1  0  0  0  0  0  1  0  0  0  0  0  0  1  0  6  0  1
 1  0  1  1  0  1  1  0  1  1  1  1  0  1  0  1  0  1
 1  0  1  0  0  0  0  0  1  2  0  0  0  0  0  1  0  1
 1  2  1  0  1  1  1  0  1  1  1  1  1  1  0  6  0  1
 1  0  8  0  1  0  0  0  0  0  0  1  0  0  0  0  0  1
 1  1  1  7  1  0  1  1  1  1  0  1  0  1  1  1  0  1
 1  0  0  0  0  0  1  5  0  0  0  0  0  0  0  1  0  1
 1  0  1  1  0  1  1  0  1  1  1  1  0  1  1  1  0  1
 1  0  0  1  0  0  0  0  1  0  0  0  0  1  2  0  0  1
 1  1  0  1  1  1  1  0  1  0  1  1  1  1  1  0  1  1
 1  2  0  0  0  0  0  0  0  0  0  0  0  0  0  0  5  1
 1  1  1  0  1  1  1  1  1  0  1  1  0  1  1  1  0  1
 1  5  0  0  1  0  3  0  0  0  0  1  2  0  0  0  0  1
 1  0  1  1  1  0  1  1  1  1  0  1  1  1  1  1  0  1
 1  1  1  1  1  1  1  1  1  1  1  1  1  1  1  1  1  1
