name: The First Spark
description: A small chamber. Find the key to open the door.
crystalsNeeded: 2
grid:
 1  1  1  1  1  1  1  1  1  1
 1  4  0  0  0  0  0  0  0  1
 1  0  1  1  1  0  1  1  0  1
 1  0  1  5  0  0  0  1  0  1
 1  0  0  0  2  6  0  0  0  1
 1  1  1  0  1  1  1  0  1  1
 1  0  0  0  0  0  0  0  0  1
 1  0  1  1  0  2  1  1  0  1
 1  0  0  0  0  0  0  3  0  1
 1  1  1  1  1  1  1  1  1  1
