name: The Winding Dark
description: Twisting corridors. Keys behind locked gates. Spikes guard the path.
crystalsNeeded: 4
grid:
 1  1  1  1  1  1  1  1  1  1  1  1  1  1
 1  4  0  0  1  0  0  0  1  2  0  0  0  1
 1  1  1  0  1  0  1  0  1  0  1  1  0  1
 1  0  0  0  0  0  1  0  0  0  6  0  0  1
 1  0  1  1  1  0  1  1  1  1  1  0  1  1
 1  5  1  2  0  0  0  9  9  0  0  0  0  1
 1  0  1  1  1  1  1  0  1  1  1  0  1  1
 1  0  0  0  2  0  0  0  0  0  6  0  0  1
 1  1  1  0  1  1  1  1  1  0  1  1  0  1
 1  5  0  0  1  0  9  0  0  0  0  0  0  1
 1  0  1  1  1  0  1  1  1  0  1  1  0  1
 1  0  0  0  0  0  1  2  0  0  0  0  3  1
 1  0  1  1  1  0  1  1  1  0  1  1  0  1
 1  1  1  1  1  1  1  1  1  1  1  1  1  1
