name: Crystal Depths
description: Deep beneath, locks guard the crystals. Stairs lead to hidden platforms.
crystalsNeeded: 6
grid:
 1  1  1  1  1  1  1  1  1  1  1  1  1  1  1  1
 1  4  0  0  0  1  0  2  0  0  0  1  0  0  0  1
 1  1  1  1  0  1  0  1  1  1  0  1  0  1  1  1
 1  0  0  0  0  0  0  1  2  0  0  0  0  0  0  1
 1  0  1  1  1  1  0  1  1  1  0  1  1  1  0  1
 1  0  1  5  0  0  0  0  0  6  0  0  0  1  0  1
 1  2  1  0  1  1  1  1  0  1  1  1  0  1  0  1
 1  0  0  0  1  5  0  0  0  0  0  1  0  0  0  1
 1  0  1  1  1  0  1  1  1  1  0  1  1  1  0  1
 1  0  0  0  0  0  6  0  0  0  0  1  8  0  0  1
 1  1  1  0  1  1  1  0  1  7  1  1  0  1  0  1
 1  0  9  0  0  1  0  0  0  1  2  0  0  1  0  1
 1  5  1  1  0  1  1  1  0  1  1  1  0  1  0  1
 1  0  0  0  0  0  0  0  0  0  0  0  0  0  0  1
 1  0  0  0  3  0  1  2  0  0  0  0  1  2  0  1
 1  1  1  1  1  1  1  1  1  1  1  1  1  1  1  1
